11 12
T T T T T T T T C C C C 
T T T T T T T T T T T T 
C C C T T T T T T T T T 
T T T T T T T T T T T T 
T T T T T T T T T T T T 
T T T T T T T T T T T T 
T T T L T T T T T C C C
T T T T T T T T T T T T 
C C C T T T T T T T T T 
T T T T T T T T T T T T 
T T T T T T T T C C C C


